Name,Rookie,JN,BD,BD_Y,Hgt,Wgt,Pos,Team,GP,G,A,PTS,Pts/G,+/-,PPG,PPA,PPP,SHG,SHA,SHPTS,GWG,ENG,PIM,Active
David Goyette,NO,88,2004-03-27,2004,5.11,181,RW,Sudbury Wolves,68,40,77,117,1.72,20,9,24,33,1,2,3,1,5,29,1
Anthony Romani,NO,15,2005-07-12,2005,6.01,184,RW,North Bay Battalion,68,58,53,111,1.63,43,14,14,28,0,0,0,7,5,20,1
Dalyn Wakely,NO,14,2004-03-05,2004,6.01,197,C,North Bay Battalion,66,39,65,104,1.58,54,6,15,21,1,1,2,5,3,71,1
Quentin Musty,NO,27,2005-07-06,2005,6.02,202,LW,Sudbury Wolves,53,43,59,102,1.92,19,13,19,32,0,0,0,8,1,72,1
Denver Barkey,NO,86,2005-04-27,2005,5.09,154,LW,London Knights,64,35,67,102,1.59,45,5,26,31,7,4,11,4,1,28,1
Deni Goure,NO,7,2003-07-15,2003,5.11,170,C,Owen Sound Attack,68,36,60,96,1.41,7,10,24,34,3,1,4,8,1,30,1
Easton Cowan,NO,7,2005-05-20,2005,5.1,171,RW,London Knights,54,34,62,96,1.78,38,3,30,33,7,7,14,4,1,64,1
Zayne Parekh,NO,19,2006-02-15,2006,6,180,D,Saginaw Spirit,66,33,63,96,1.45,39,10,24,34,2,0,2,6,1,64,1
Carson Rehkopf,NO,16,2005-01-07,2005,6.01,195,RW,Kitchener Rangers,60,52,43,95,1.58,23,16,16,32,0,0,0,10,2,45,1
Hunter Brzustewicz,NO,4,2004-11-29,2004,6,188,RD,Kitchener Rangers,67,13,79,92,1.37,31,2,22,24,0,1,1,1,0,24,1
Matthew Sop,NO,91,2003-02-04,2003,6,182,C,Kitchener Rangers,67,43,47,90,1.34,19,6,15,21,3,2,5,10,3,59,1
Liam Greentree,NO,66,2006-01-01,2006,6.02,198,LW,Windsor Spitfires,64,36,54,90,1.41,-14,11,12,23,0,4,4,1,3,33,1
Dalibor Dvorský,NO,51,2005-06-15,2005,6.01,201,C,Sudbury Wolves,52,45,43,88,1.69,5,15,17,32,3,0,3,3,1,17,1
Owen Van Steensel,NO,16,2004-08-04,2004,5.1,184,LW,North Bay Battalion,65,41,45,86,1.32,41,8,6,14,3,0,3,1,3,40,1
Jack Beck,NO,12,2003-04-12,2003,6,180,LW,Soo Greyhounds,67,27,58,85,1.27,9,3,32,35,0,1,1,1,0,18,1
Luca Pinelli,NO,20,2005-04-05,2005,5.09,169,LW,Ottawa 67's,68,48,34,82,1.21,1,15,10,25,1,1,2,5,1,44,1
Marek Vanacker,NO,78,2006-04-12,2006,6.01,170,LW,Brantford Bulldogs,68,36,46,82,1.21,7,4,18,22,5,0,5,4,0,55,1
Beau Jelsma,NO,53,2004-04-28,2004,5.09,174,C,Barrie Colts,67,37,44,81,1.21,0,7,18,25,3,1,4,5,4,31,1
Ruslan Gazizov,NO,70,2004-01-21,2004,5.11,185,RW,London Knights,63,36,45,81,1.29,42,10,14,24,5,2,7,6,3,59,1
Owen Beck,NO,62,2004-02-03,2004,6,190,C,Saginaw Spirit,57,34,47,81,1.42,26,10,14,24,2,1,3,9,1,18,1
Luke Misa,NO,33,2005-11-25,2005,5.1,175,C,Mississauga Steelheads,66,26,55,81,1.23,35,6,15,21,1,0,1,3,3,8,1
Oliver Peer,NO,94,2003-03-09,2003,6,170,C,Flint Firebirds,67,37,43,80,1.19,-16,6,15,21,4,1,5,3,2,20,1
Calum Ritchie,NO,21,2005-01-21,2005,6.02,179,C,Oshawa Generals,50,28,52,80,1.6,45,5,14,19,1,0,1,4,3,20,1
Jacob Julien,NO,13,2004-09-12,2004,6.03,170,C,London Knights,67,29,49,78,1.16,32,8,21,29,3,1,4,2,0,53,1
Gavin Hayes,NO,23,2004-05-14,2004,6.02,178,RW,Soo Greyhounds,55,37,39,76,1.38,26,14,9,23,3,2,5,8,5,20,1
Ethan Burroughs,NO,29,2003-06-19,2003,5.1,187,RW,Owen Sound Attack,68,31,45,76,1.12,-4,10,18,28,3,2,5,3,2,66,1
Pano Fimis,NO,98,2004-06-17,2004,5.11,183,C,Erie Otters,68,25,51,76,1.12,5,6,17,23,1,0,1,2,0,53,1
Michael Misa,NO,77,2007-02-16,2007,6,175,LW,Saginaw Spirit,67,29,46,75,1.12,3,11,20,31,0,0,0,4,1,26,1
Braeden Kressler,NO,12,2003-01-05,2003,5.09,170,C,Ottawa 67's,65,28,46,74,1.14,17,9,15,24,1,4,5,3,2,34,1
Jett Luchanko,NO,7,2006-08-21,2006,5.11,183,C,Guelph Storm,68,20,54,74,1.09,-13,3,30,33,1,1,2,3,1,36,1
Rodwin Dionicio,NO,94,2004-03-30,2004,6.02,205,D,Saginaw Spirit,60,25,48,73,1.22,21,8,14,22,0,1,1,2,0,108,1
Dylan Roobroeck,NO,25,2004-07-27,2004,6.07,195,C,Oshawa Generals,68,26,46,72,1.06,23,7,12,19,0,1,1,2,3,101,1
Braeden Bowman,NO,15,2003-06-26,2003,6.02,195,RW,Guelph Storm,68,37,34,71,1.04,-17,16,17,33,2,1,3,7,2,51,1
Porter Martone,NO,94,2006-10-26,2006,6.03,196,RW,Mississauga Steelheads,60,33,38,71,1.18,25,10,11,21,0,1,1,3,2,63,1
Sam Dickinson,NO,3,2006-06-07,2006,6.03,195,D,London Knights,68,18,52,70,1.03,56,11,17,28,0,3,3,2,0,30,1
Justin Ertel,NO,9,2003-05-27,2003,6.02,187,LW,North Bay Battalion,64,25,44,69,1.08,24,3,16,19,4,1,5,4,2,74,1
Paul Ludwinski,NO,19,2004-04-23,2004,5.11,187,C,Kingston Frontenacs,60,23,46,69,1.15,-5,5,17,22,2,0,2,7,0,27,1
Beckett Sennecke,NO,45,2006-01-28,2006,6.03,178,RW,Oshawa Generals,63,27,41,68,1.08,33,7,14,21,0,0,0,7,1,67,1
Sandis Vilmanis,NO,23,2004-01-23,2004,6.02,192,RW,North Bay Battalion,60,38,29,67,1.12,1,9,12,21,1,0,1,7,2,10,1
Hunter Haight,NO,37,2004-04-04,2004,5.11,180,C,Saginaw Spirit,68,25,42,67,0.99,14,6,15,21,0,0,0,3,1,28,1
Oliver Bonk,NO,59,2005-01-09,2005,6.02,179,D,London Knights,60,24,43,67,1.12,28,15,18,33,0,5,5,5,0,32,1
Ryan Abraham,NO,12,2004-04-05,2004,5.08,168,C,Windsor Spitfires,64,31,35,66,1.03,-29,4,14,18,1,1,2,2,1,82,1
Patrick Thomas,NO,93,2004-08-21,2004,6,175,C,Brantford Bulldogs,57,21,45,66,1.16,9,8,13,21,1,0,1,2,2,10,1
Florian Xhekaj,NO,43,2004-06-27,2004,6.04,190,LW,Brantford Bulldogs,63,34,31,65,1.03,17,5,10,15,1,0,1,6,1,81,1
Jacob Battaglia,NO,88,2006-03-17,2006,6,203,RW,Kingston Frontenacs,67,31,34,65,0.97,-15,12,10,22,0,0,0,1,0,34,1
Kocha Delic,NO,13,2004-03-11,2004,5.1,185,LW,Sudbury Wolves,57,30,34,64,1.12,10,5,6,11,0,1,1,7,0,43,1
Nolan Dann,NO,9,2003-05-21,2003,5.09,182,RW,Flint Firebirds,65,28,36,64,0.98,-22,5,9,14,0,0,0,3,0,16,1
Jake O'Brien,YES,44,2007-06-16,2007,6.01,165,C,Brantford Bulldogs,61,13,51,64,1.05,4,8,19,27,0,0,0,4,0,10,1
Calem Mangone,NO,7,2004-11-04,2004,5.09,165,RW,Saginaw Spirit,62,22,41,63,1.02,28,6,11,17,0,0,0,2,2,42,1
Sam Sedley,NO,9,2003-06-08,2003,5.11,192,D,Owen Sound Attack,64,9,54,63,0.98,-18,2,26,28,0,3,3,2,1,35,1
Angus MacDonell,NO,17,2005-05-11,2005,5.1,181,C,Mississauga Steelheads,61,32,30,62,1.02,20,5,9,14,2,0,2,5,2,90,1
Riley Patterson,YES,21,2006-03-22,2006,6,194,C,Barrie Colts,68,29,33,62,0.91,7,3,11,14,0,1,1,4,1,10,1
Cole Beaudoin,NO,29,2006-04-24,2006,6.02,206,C,Barrie Colts,67,28,34,62,0.93,2,12,6,18,3,1,4,4,1,27,1
Trent Swick,NO,57,2004-04-25,2004,6.06,208,LW,Kitchener Rangers,63,25,37,62,0.98,24,8,7,15,2,0,2,2,0,60,1
Matyas Sapovaliv,NO,24,2004-02-12,2004,6.04,195,C,Saginaw Spirit,54,19,43,62,1.15,24,7,17,24,1,0,1,6,0,22,1
Malcolm Spence,NO,17,2006-09-22,2006,6.02,192,LW,Erie Otters,66,19,43,62,0.94,11,0,11,11,4,3,7,1,2,26,1
Kasper Halttunen,NO,12,2005-06-07,2005,6.03,215,RW,London Knights,57,32,29,61,1.07,18,16,12,28,0,0,0,4,0,61,1
Max McCue,NO,39,2003-02-10,2003,6.01,183,RW,London Knights,62,27,34,61,0.98,27,8,5,13,2,2,4,8,2,110,1
Henry Mews,NO,11,2006-03-09,2006,6.01,183,D,Ottawa 67's,65,15,46,61,0.94,16,2,19,21,0,0,0,3,0,65,1
Sam Alfano,NO,33,2004-01-18,2004,6.04,221,RW,Erie Otters,66,27,33,60,0.91,9,9,4,13,0,0,0,4,0,43,1
Christopher Thibodeau,NO,10,2005-10-13,2005,5.09,144,RW,Kingston Frontenacs,68,21,39,60,0.88,2,0,14,14,2,0,2,4,0,14,1
Connor Lockhart,NO,73,2003-01-21,2003,5.09,171,RW,Oshawa Generals,52,27,32,59,1.13,31,6,7,13,0,0,0,4,2,55,1
Landon McCallum,NO,11,2003-09-05,2003,5.11,175,RW,Sudbury Wolves,64,21,38,59,0.92,13,5,11,16,0,2,2,3,0,87,1
Jacob Maillet,NO,27,2003-03-13,2003,6.01,193,C,Ottawa 67's,69,17,42,59,0.86,0,3,9,12,1,3,4,1,2,18,1
Colby Barlow,NO,39,2005-02-14,2005,6.01,195,LW,Owen Sound Attack,50,40,18,58,1.16,-1,16,5,21,3,0,3,2,2,27,1
Stuart Rolofs,NO,89,2003-03-28,2003,6.03,201,LW,Oshawa Generals,64,32,26,58,0.91,23,3,6,9,0,0,0,2,1,22,1
Adrian Misaljevic,NO,10,2004-07-10,2004,5.11,154,RW,Kitchener Rangers,65,23,35,58,0.89,17,2,8,10,0,0,0,1,2,18,1
Cedrick Guindon,NO,11,2004-04-21,2004,5.1,180,C,Owen Sound Attack,68,26,31,57,0.84,-30,8,16,24,0,1,1,3,0,22,1
Marko Sikic,NO,15,2003-03-24,2003,6.03,183,RW,Sarnia Sting,66,18,39,57,0.86,-16,3,15,18,3,0,3,0,0,28,1
Luca Marrelli,NO,19,2005-10-04,2005,6.02,183,D,Oshawa Generals,67,6,51,57,0.85,28,1,18,19,0,0,0,2,0,16,1
Rasmus Kumpulainen,NO,68,2005-08-08,2005,6.02,200,C,Oshawa Generals,58,28,28,56,0.97,14,10,6,16,0,0,0,1,2,48,1
Matthew Soto,NO,92,2005-08-31,2005,5.11,179,RW,Kingston Frontenacs,66,25,31,56,0.85,-15,10,10,20,0,0,0,4,0,12,1
Sam O'Reilly,YES,23,2006-03-30,2006,6.01,180,C,London Knights,68,20,36,56,0.82,32,4,7,11,2,1,3,2,1,34,1
Zakary Lavoie,NO,29,2004-03-13,2004,5.1,187,RW,Brantford Bulldogs,67,31,24,55,0.82,-2,11,4,15,1,2,3,6,2,32,1
Coulson Pitre,NO,11,2004-12-13,2004,6.01,185,RW,Flint Firebirds,55,27,28,55,1,-9,1,6,7,3,0,3,1,1,41,1
Jake Karabela,NO,10,2004-03-07,2004,5.11,179,C,Guelph Storm,65,25,30,55,0.85,-16,14,10,24,1,0,1,1,0,56,1
Servac Petrovsky,NO,18,2004-08-10,2004,5.11,177,C,Owen Sound Attack,57,20,35,55,0.96,-12,8,16,24,1,1,2,3,1,14,1
Zacharie Giroux,NO,96,2003-04-05,2003,5.06,162,C,Sudbury Wolves,61,20,35,55,0.9,-8,4,10,14,3,0,3,2,3,33,1
Connor Punnett,NO,14,2003-06-16,2003,6.02,199,D,Oshawa Generals,66,11,44,55,0.83,8,4,23,27,1,0,1,0,3,123,1
Nick DeAngelis,NO,95,2004-05-22,2004,6.02,195,D,Sudbury Wolves,66,3,52,55,0.83,7,3,26,29,0,0,0,1,0,29,1
Jax Dubois,NO,63,2003-06-18,2003,6.04,205,C,Kingston Frontenacs,65,24,30,54,0.83,0,5,7,12,1,1,2,1,2,57,1
Gavin Bryant,NO,19,2004-07-24,2004,5.11,192,C,Niagara IceDogs,62,21,33,54,0.87,-17,4,7,11,4,5,9,4,3,15,1
Kevin He,NO,11,2006-04-30,2006,6,182,LW,Niagara IceDogs,64,31,22,53,0.83,-13,3,4,7,3,3,6,3,1,66,1
Alex Christopoulos,NO,48,2003-03-26,2003,6,195,RW,Saginaw Spirit,58,30,23,53,0.91,19,10,1,11,0,0,0,6,0,26,1
Linus Hemström,NO,90,2004-01-16,2004,6,169,RW,Kingston Frontenacs,61,23,30,53,0.87,-7,7,10,17,1,3,4,2,2,18,1
Marco Mignosa,NO,26,2005-04-13,2005,5.11,166,RW,Soo Greyhounds,57,22,31,53,0.93,19,6,7,13,2,4,6,4,1,24,1
Samuel Mayer,NO,19,2003-04-15,2003,6.03,202,D,Ottawa 67's,69,21,32,53,0.77,-11,9,14,23,1,0,1,2,1,100,1
Chas Sharpe,NO,28,2003-11-28,2003,6.03,196,D,Mississauga Steelheads,67,19,34,53,0.79,10,10,16,26,0,0,0,3,1,30,1
Carey Terrance,NO,10,2005-05-10,2005,6.01,179,C,Erie Otters,56,29,23,52,0.93,5,2,10,12,5,1,6,5,4,25,1
Cooper Foster,NO,29,2005-06-04,2005,6,187,C,Ottawa 67's,59,21,31,52,0.88,10,3,8,11,1,0,1,6,1,33,1
Filip Mešár,NO,48,2004-01-03,2004,5.1,168,C,Kitchener Rangers,45,19,33,52,1.16,7,8,15,23,0,0,0,3,1,12,1
Ondrej Molnar,NO,96,2005-02-08,2005,5.1,175,LW,Erie Otters,66,19,33,52,0.79,-19,8,7,15,0,0,0,2,1,26,1
Ty Nelson,NO,24,2004-03-30,2004,5.1,206,D,North Bay Battalion,54,16,36,52,0.96,11,10,18,28,0,1,1,2,1,50,1
Matthew Buckley,NO,11,2005-03-21,2005,5.11,181,RW,Oshawa Generals,63,30,21,51,0.81,14,4,8,12,0,0,0,6,2,22,1
Ryan Roobroeck,YES,25,2007-09-25,2007,6.02,195,LW,Niagara IceDogs,63,28,23,51,0.81,-34,3,5,8,1,0,1,2,1,14,1
Bryce McConnell-Barker,NO,18,2004-06-04,2004,6.02,188,C,Soo Greyhounds,52,22,29,51,0.98,-2,7,9,16,1,1,2,5,1,22,1
Andrew LeBlanc,NO,27,2004-06-03,2004,6.01,176,LW,North Bay Battalion,63,16,35,51,0.81,4,2,8,10,0,0,0,5,1,64,1
Nick Lardis,NO,16,2005-07-08,2005,5.11,171,RW,Brantford Bulldogs,37,29,21,50,1.35,5,6,7,13,0,1,1,3,3,12,1
Max Namestnikov,NO,26,2004-02-06,2004,5.08,182,LW,Guelph Storm,68,24,26,50,0.74,-17,10,8,18,0,0,0,1,0,49,1
Nathan Villeneuve,NO,89,2006-04-13,2006,6,190,C,Sudbury Wolves,56,23,27,50,0.89,10,3,4,7,3,0,3,3,0,58,1
Joey Willis,NO,14,2005-03-14,2005,5.1,180,C,Saginaw Spirit,66,14,36,50,0.76,25,1,8,9,1,1,2,2,1,15,1
Valentin Zhugin,NO,13,2004-12-13,2004,5.11,180,LW,Windsor Spitfires,67,23,26,49,0.73,-34,5,7,12,0,0,0,1,2,23,1
Tai York,NO,23,2004-06-18,2004,6.01,185,LW,Barrie Colts,64,17,32,49,0.77,5,4,7,11,0,0,0,1,0,28,1
Brad Gardiner,NO,25,2005-03-06,2005,6.01,189,C,Ottawa 67's,67,16,33,49,0.73,-3,3,9,12,0,0,0,1,1,34,1
Evan Konyen,NO,91,2004-02-22,2004,5.11,170,RW,Sudbury Wolves,55,23,25,48,0.87,14,4,5,9,0,0,0,2,3,28,1
Dean Loukus,NO,12,2003-02-12,2003,5.1,180,RW,Mississauga Steelheads,65,17,31,48,0.74,-4,5,10,15,0,0,0,1,0,30,1
Martin Misiak,NO,90,2004-09-30,2004,6.02,200,C,Erie Otters,60,23,24,47,0.78,-14,8,7,15,1,0,1,3,2,33,1
Tommy Purdeller,NO,20,2004-04-13,2004,6,194,C,Peterborough Petes,63,13,34,47,0.75,-32,3,14,17,0,0,0,1,1,26,1
Michael Buchinger,NO,4,2004-04-25,2004,6,191,D,Guelph Storm,52,10,37,47,0.9,-8,3,23,26,0,1,1,1,1,37,1
Jacob LeBlanc,NO,18,2004-06-03,2004,6.01,180,D,North Bay Battalion,68,7,40,47,0.69,11,2,11,13,0,0,0,3,0,47,1
Kirill Kudryavtsev,NO,29,2004-02-05,2004,6,202,D,Soo Greyhounds,67,5,42,47,0.7,29,0,13,13,1,3,4,1,0,18,1
Tyson Doucette,NO,25,2004-01-30,2004,5.11,170,LW,Sarnia Sting,68,23,23,46,0.68,-27,8,10,18,0,1,1,2,0,38,1
Simon Slavicek,NO,61,2004-02-02,2004,6,170,C,Flint Firebirds,55,15,31,46,0.84,-5,3,3,6,0,1,1,6,0,16,1
Jorian Donovan,NO,75,2004-04-05,2004,6.02,195,D,Saginaw Spirit,66,13,33,46,0.7,19,1,6,7,0,2,2,1,1,73,1
Luca D'Amato,NO,4,2004-08-18,2004,5.09,160,D,Oshawa Generals,67,13,33,46,0.69,26,0,11,11,0,1,1,1,0,58,1
Will Gerrior,NO,23,2004-03-02,2004,5.1,174,LW,Ottawa 67's,67,26,19,45,0.67,11,1,3,4,1,2,3,2,0,24,1
Arttu Karki,NO,39,2004-12-08,2004,6.02,178,D,Soo Greyhounds,59,21,24,45,0.76,15,12,11,23,0,1,1,3,2,10,1
Jonathan Melee,NO,23,2004-01-15,2004,6,182,C,Peterborough Petes,56,14,31,45,0.8,-7,3,8,11,0,0,0,3,0,42,1
Brady Stonehouse,NO,17,2004-08-06,2004,5.1,194,RW,Ottawa 67's,64,20,24,44,0.69,-6,5,11,16,0,1,1,4,2,59,1
Owen Allard,NO,14,2004-01-13,2004,6.02,200,C,Soo Greyhounds,55,18,26,44,0.8,18,5,5,10,2,4,6,2,1,39,1
Brett Bressette,NO,89,2003-07-04,2003,5.09,174,LW,Erie Otters,67,17,27,44,0.66,-10,4,14,18,0,0,0,2,1,14,1
Andrew Gibson,NO,6,2005-02-13,2005,6.04,206,D,Soo Greyhounds,68,12,32,44,0.65,36,1,7,8,1,0,1,2,0,58,1
Tristan Bertucci,NO,12,2005-07-12,2005,6.02,172,D,Flint Firebirds,61,10,34,44,0.72,8,4,11,15,1,2,3,2,1,77,1
Kieron Walton,NO,22,2006-04-22,2006,6.06,210,LW,Sudbury Wolves,65,18,25,43,0.66,-5,4,4,8,0,1,1,2,0,18,1
Lucas Karmiris,NO,27,2006-09-27,2006,5.11,181,C,Mississauga Steelheads,62,14,29,43,0.69,19,0,6,6,0,2,2,2,1,28,1
Jakub Fibigr,YES,5,2006-07-22,2006,6,171,D,Mississauga Steelheads,61,7,36,43,0.7,13,2,11,13,0,0,0,2,0,35,1
Justin Cloutier,NO,24,2005-06-20,2005,5.08,182,RW,Soo Greyhounds,68,24,18,42,0.62,7,4,3,7,3,0,3,2,3,32,1
Luke Torrance,NO,17,2004-03-30,2004,6.01,202,LW,Oshawa Generals,54,21,20,41,0.76,22,9,5,14,0,1,1,4,0,27,1
Jordan D'Intino,NO,38,2003-03-01,2003,6.01,190,LW,Soo Greyhounds,54,20,21,41,0.76,10,4,5,9,3,1,4,2,2,36,1
Cole Davis,YES,86,2006-06-22,2006,5.1,175,LW,Windsor Spitfires,63,20,21,41,0.65,-37,6,5,11,2,1,3,2,1,55,1
Braydon McCallum,YES,29,2006-05-03,2006,5.1,165,RW,Peterborough Petes,62,18,23,41,0.66,-9,5,3,8,1,0,1,2,2,128,1
Ethan Miedema,NO,15,2005-03-22,2005,6.04,201,LW,Kingston Frontenacs,68,18,23,41,0.6,-12,8,5,13,0,0,0,2,0,47,1
Andre Anania,NO,78,2003-03-02,2003,6.01,200,D,Sudbury Wolves,60,10,31,41,0.68,49,0,2,2,1,0,1,1,0,62,1
Zach Filak,NO,11,2004-01-21,2004,6,175,C,Sarnia Sting,61,24,16,40,0.66,-21,6,4,10,0,3,3,2,1,71,1
Josh Bloom,NO,17,2003-06-08,2003,6.02,185,LW,Saginaw Spirit,34,17,23,40,1.18,18,4,7,11,0,1,1,3,1,15,1
Ben Bujold,NO,89,2004-03-03,2004,6,179,C,Brantford Bulldogs,63,14,26,40,0.63,19,0,1,1,3,1,4,0,2,16,1
Chase Lefebvre,NO,7,2004-05-13,2004,6.02,170,C,Peterborough Petes,68,17,22,39,0.57,-46,4,7,11,0,0,0,2,1,38,1
Cole Brown,NO,92,2005-04-27,2005,6.03,180,RW,Brantford Bulldogs,65,16,23,39,0.6,-7,2,3,5,0,0,0,1,1,45,1
Kashawn Aitcheson,NO,77,2006-09-21,2006,6.01,191,D,Barrie Colts,64,8,31,39,0.61,-1,1,6,7,0,4,4,1,0,126,1
AJ Spellacy,NO,8,2006-02-24,2006,6.03,195,C,Windsor Spitfires,67,21,17,38,0.57,-22,3,4,7,5,0,5,3,0,59,1
Jacob Therrien,NO,6,2006-02-08,2006,5.08,165,RW,North Bay Battalion,61,20,18,38,0.62,2,1,3,4,0,0,0,0,1,77,1
Eduard Šalé,NO,12,2005-03-10,2005,6.02,178,LW,Kitchener Rangers,49,15,23,38,0.78,-2,5,10,15,0,0,0,1,0,8,1
Donovan McCoy,NO,19,2004-11-10,2004,6,198,D,Sudbury Wolves,67,9,29,38,0.57,-3,1,9,10,1,2,3,3,0,62,1
Anthony Cristoforo,NO,74,2006-02-23,2006,5.11,180,D,Windsor Spitfires,67,7,31,38,0.57,-43,4,12,16,0,1,1,1,0,29,1
Sam McCue,NO,12,2005-10-03,2005,6.01,177,RW,Owen Sound Attack,68,23,14,37,0.54,-10,5,2,7,0,0,0,0,0,53,1
Kaleb Lawrence,NO,25,2003-01-10,2003,6.06,221,C,London Knights,58,20,17,37,0.64,11,3,1,4,1,0,1,4,2,89,1
Easton Wainwright,NO,12,2005-01-19,2005,5.1,178,C,Sarnia Sting,54,13,24,37,0.69,-18,2,5,7,1,1,2,3,0,25,1
Alexis Daviault,NO,72,2005-06-17,2005,6,190,D,Erie Otters,65,7,30,37,0.57,-5,1,13,14,0,2,2,1,0,53,1
Ethan Procyszyn,NO,21,2006-07-11,2006,6.03,189,C,North Bay Battalion,62,15,21,36,0.58,2,2,3,5,0,0,0,2,0,67,1
Zander Veccia,NO,27,2004-07-27,2004,5.1,184,RW,Guelph Storm,60,10,26,36,0.6,-3,1,5,6,0,0,0,3,1,22,1
Mason Zebeski,NO,19,2005-10-04,2005,6.01,186,LW,Mississauga Steelheads,55,24,11,35,0.64,9,7,3,10,0,0,0,7,0,52,1
Charlie Paquette,NO,23,2005-12-06,2005,6.01,192,RW,Guelph Storm,68,21,14,35,0.51,-15,3,2,5,0,0,0,7,0,55,1
Mike Levin,NO,16,2005-10-16,2005,5.08,150,LW,Niagara IceDogs,60,18,17,35,0.58,-14,2,3,5,0,1,1,2,0,27,1
Bruce McDonald,NO,92,2004-12-18,2004,6,175,C,Erie Otters,65,18,17,35,0.54,3,1,1,2,3,1,4,2,0,17,1
Travis Hayes,YES,13,2007-09-03,2007,5.11,168,RW,Soo Greyhounds,58,14,21,35,0.6,9,3,5,8,0,0,0,2,0,44,1
Quinton Burns,NO,41,2005-04-14,2005,6.01,178,D,Kingston Frontenacs,58,6,29,35,0.6,-19,0,11,11,1,1,2,0,2,120,1
Dylan Edwards,NO,11,2005-07-20,2005,5.08,162,RW,Erie Otters,38,22,12,34,0.89,19,1,0,1,0,0,0,2,1,13,1
Nathan Aspinall,NO,76,2006-03-30,2006,6.07,189,LW,Flint Firebirds,65,18,16,34,0.52,-8,2,0,2,0,0,0,3,0,23,1
Noah Morneau,NO,11,2004-05-07,2004,6,160,C,Windsor Spitfires,66,13,21,34,0.52,-34,4,3,7,1,0,1,0,0,25,1
Sebastien Gervais,NO,15,2005-04-11,2005,6.01,185,LW,Saginaw Spirit,68,12,22,34,0.5,0,2,2,4,0,0,0,2,0,23,1
Liam Arnsby,NO,11,2003-11-20,2003,5.11,180,C,North Bay Battalion,60,11,23,34,0.57,9,1,1,2,1,2,3,2,1,93,1
Luke McNamara,NO,29,2005-03-02,2005,6.02,180,C,Kingston Frontenacs,60,10,24,34,0.57,-6,1,0,1,0,0,0,1,0,35,1
Finn Harding,NO,7,2005-03-02,2005,6.01,198,D,Mississauga Steelheads,68,10,24,34,0.5,39,1,6,7,1,0,1,0,2,54,1
Lukas Fischer,NO,13,2006-09-09,2006,6.03,170,D,Sarnia Sting,68,6,28,34,0.5,-27,4,9,13,0,0,0,0,0,79,1
Vilmer Alriksson,NO,25,2005-02-18,2005,6.06,215,LW,Guelph Storm,67,17,16,33,0.49,0,7,2,9,0,0,0,3,0,35,1
Jacob Frasca,NO,15,2003-03-19,2003,6.05,216,RW,Soo Greyhounds,45,16,17,33,0.73,6,5,5,10,1,0,1,4,1,40,1
Luke Ellinas,YES,19,2006-03-12,2006,6.01,186,LW,Kitchener Rangers,67,16,17,33,0.49,8,2,1,3,0,1,1,2,1,75,1
Ben Danford,NO,77,2006-02-06,2006,6.02,190,D,Oshawa Generals,64,1,32,33,0.52,27,0,4,4,0,0,0,0,0,25,1
Jack Van Volsen,NO,14,2006-01-12,2006,6.02,188,C,Mississauga Steelheads,63,20,12,32,0.51,-2,5,5,10,0,0,0,2,0,27,1
Gabriel Frasca,NO,18,2006-02-18,2006,6,170,C,Kingston Frontenacs,44,15,17,32,0.73,-13,5,7,12,0,0,0,4,0,18,1
Roman Schmidt,NO,76,2003-02-27,2003,6.05,216,D,Kingston Frontenacs,47,8,24,32,0.68,-4,5,14,19,0,0,0,1,0,62,1
Matthew Andonovski,NO,5,2005-03-14,2005,6.02,200,LD,Kitchener Rangers,65,7,25,32,0.49,58,0,0,0,0,1,1,0,0,124,1
Ryder McIntyre,NO,21,2004-07-15,2004,6.03,218,RW,Peterborough Petes,55,14,17,31,0.56,-14,1,1,2,0,0,0,0,1,46,1
Spencer Sova,NO,22,2004-01-10,2004,6.01,188,D,Erie Otters,58,14,17,31,0.53,-5,6,3,9,0,0,0,2,0,35,1
Tanner Lam,YES,37,2007-07-14,2007,5.08,140,RW,Kitchener Rangers,61,13,18,31,0.51,1,3,3,6,0,0,0,1,0,4,1
Mathieu Paris,NO,54,2005-01-01,2005,6,175,RW,Niagara IceDogs,54,11,20,31,0.57,-24,1,2,3,2,1,3,0,0,8,1
Christopher Brown,NO,67,2006-01-27,2006,5.11,166,C,Soo Greyhounds,66,7,24,31,0.47,13,0,1,1,0,1,1,1,0,8,1
Alex Pharand,NO,21,2005-01-05,2005,6.03,198,RW,Sudbury Wolves,68,17,13,30,0.44,12,1,2,3,2,0,2,1,1,38,1
Mitch Young,NO,5,2005-04-29,2005,6.01,183,D,Sarnia Sting,65,11,19,30,0.46,-23,1,3,4,0,0,0,2,0,77,1
Simon Motew,NO,46,2003-03-31,2003,6,187,RD,Kitchener Rangers,68,11,19,30,0.44,2,1,3,4,0,0,0,1,0,93,1
Kaden Pitre,NO,17,2006-02-08,2006,6,185,C,Flint Firebirds,35,10,20,30,0.86,-9,1,7,8,1,0,1,0,1,29,1
Nick Yearwood,NO,18,2004-07-15,2004,6,190,LW,Sudbury Wolves,62,8,22,30,0.48,6,0,0,0,2,2,4,0,0,54,1
Jackson Edward,NO,92,2004-02-27,2004,6.03,191,D,London Knights,59,7,23,30,0.51,43,1,5,6,0,1,1,1,0,92,1
Isaiah George,NO,4,2004-02-15,2004,6,199,D,London Knights,68,6,24,30,0.44,26,0,0,0,0,4,4,1,0,54,1
Landen Hookey,NO,10,2004-01-29,2004,6.05,215,RW,Owen Sound Attack,64,15,14,29,0.45,-8,2,2,4,0,0,0,2,1,66,1
Connor Clattenburg,NO,23,2005-05-02,2005,6.02,197,LW,Flint Firebirds,60,13,16,29,0.48,1,3,0,3,0,0,0,2,1,79,1
Roenick Jodoin,NO,92,2004-09-10,2004,5.06,157,C,Barrie Colts,61,13,16,29,0.48,-25,4,0,4,0,0,0,1,0,30,1
Cooper Way,NO,9,2003-06-11,2003,6.03,199,C,Sarnia Sting,68,11,18,29,0.43,-24,4,6,10,0,0,0,1,2,50,1
Landon Sim,NO,90,2004-07-17,2004,5.11,174,LW,London Knights,39,10,19,29,0.74,21,1,1,2,1,1,2,2,0,63,1
Adam Zidlicky,NO,91,2005-01-28,2005,6,170,LW,Mississauga Steelheads,54,10,19,29,0.54,6,2,3,5,0,0,0,1,1,82,1
Carson Woodall,YES,24,2006-05-25,2006,5.11,170,D,Windsor Spitfires,57,6,23,29,0.51,-24,0,10,10,0,0,0,1,0,22,1
Owain Johnston,NO,7,2003-10-19,2003,6.01,193,D,Erie Otters,68,5,24,29,0.43,21,1,4,5,0,1,1,0,1,83,1
Brenden Sirizzotti,NO,57,2003-04-14,2003,6,193,RW,Barrie Colts,38,14,14,28,0.74,4,2,7,9,0,0,0,3,0,8,1
Colton Smith,NO,61,2004-02-09,2004,6.03,215,LW,Windsor Spitfires,68,13,15,28,0.41,-36,1,6,7,0,0,0,1,0,23,1
Lawson Sherk,NO,39,2003-05-03,2003,6.03,198,C,Brantford Bulldogs,65,11,17,28,0.43,-10,1,1,2,3,2,5,3,0,53,1
Brady Martin,YES,44,2007-03-16,2007,6,175,C,Soo Greyhounds,52,10,18,28,0.54,12,3,2,5,0,0,0,0,0,40,1
Declan Waddick,NO,27,2005-01-24,2005,5.09,162,LW,Owen Sound Attack,65,13,14,27,0.42,-17,2,2,4,0,0,0,2,0,7,1
Alex Assadourian,NO,8,2005-07-24,2005,5.09,168,C,Niagara IceDogs,45,8,19,27,0.6,-24,2,7,9,3,1,4,1,1,32,1
Calvin Crombie,NO,14,2005-09-03,2005,6,186,RW,Brantford Bulldogs,60,14,12,26,0.43,11,0,1,1,0,0,0,2,0,74,1
Bode Stewart,NO,71,2006-02-09,2006,6.01,169,LW,Barrie Colts,57,13,13,26,0.46,-8,1,0,1,1,0,1,1,0,23,1
Alex Kostov,NO,47,2006-06-03,2006,6.03,192,RW,Flint Firebirds,66,12,14,26,0.39,-4,1,0,1,4,0,4,2,1,65,1
Nolan Collins,NO,77,2004-04-28,2004,6.04,205,D,Sudbury Wolves,65,6,20,26,0.4,20,0,0,0,0,1,1,1,0,60,1
Lucas Moore,NO,4,2005-06-07,2005,5.1,185,D,Brantford Bulldogs,66,5,21,26,0.39,24,2,5,7,0,0,0,0,0,47,1
Carson Cameron,YES,15,2007-06-27,2007,6,171,D,Peterborough Petes,59,4,22,26,0.44,-35,0,11,11,1,0,1,1,0,54,1
Zach Wigle,NO,9,2004-01-12,2004,6,193,C,Barrie Colts,63,18,7,25,0.4,0,0,0,0,3,0,3,1,0,8,1
Luca Testa,NO,91,2006-04-10,2006,6,172,C,Brantford Bulldogs,48,14,11,25,0.52,6,5,1,6,0,0,0,1,0,28,1
Brice Cooke,NO,8,2004-03-23,2004,6.02,202,C,North Bay Battalion,63,13,12,25,0.4,-12,0,2,2,0,0,0,2,0,18,1
Frankie Marrelli,NO,8,2006-02-16,2006,5.11,187,D,Ottawa 67's,60,9,16,25,0.42,30,2,2,4,1,0,1,1,1,62,1
Thomas Stewart,NO,22,2003-01-06,2003,6.02,187,D,Barrie Colts,69,8,17,25,0.36,17,1,1,2,0,0,0,1,0,66,1
Daniil Sobolev,NO,13,2003-03-03,2003,6.01,223,D,Brantford Bulldogs,64,7,18,25,0.39,6,0,1,1,1,2,3,0,0,63,1
Kyle Morey,NO,17,2005-06-27,2005,5.11,160,C,Barrie Colts,67,7,18,25,0.37,2,0,1,1,0,0,0,3,0,18,1
Roberto Mancini,NO,55,2003-07-08,2003,6.04,215,D,Flint Firebirds,64,5,20,25,0.39,4,2,4,6,0,2,2,0,0,66,1
Shamar Moses,YES,78,2007-05-06,2007,6.01,208,RW,Barrie Colts,66,5,20,25,0.38,-21,2,9,11,0,0,0,1,0,42,1
James Petrovski,NO,28,2005-08-12,2005,6.04,190,D,Owen Sound Attack,63,4,21,25,0.4,3,1,6,7,0,2,2,0,0,43,1
Taos Jordan,NO,24,2004-03-29,2004,5.11,187,D,Owen Sound Attack,68,4,21,25,0.37,-3,2,3,5,0,0,0,0,0,57,1
Parker Von Richter,NO,6,2006-05-17,2006,6.01,183,D,Mississauga Steelheads,65,3,22,25,0.38,1,1,5,6,0,0,0,1,0,35,1
Antonino Pugliese,NO,44,2004-04-09,2004,5.09,179,RW,Kitchener Rangers,64,15,9,24,0.38,12,1,0,1,2,0,2,4,0,65,1
Ben Cormier,NO,8,2006-07-20,2006,6,177,C,Owen Sound Attack,65,14,10,24,0.37,-13,1,2,3,0,0,0,2,1,4,1
Ethan Hay,NO,68,2005-01-15,2005,6.01,195,C,Saginaw Spirit,67,12,12,24,0.36,1,2,1,3,1,1,2,4,0,68,1
Brody Crane,NO,29,2004-05-29,2004,5.11,185,LW,Guelph Storm,47,10,14,24,0.51,-16,1,3,4,0,0,0,1,0,8,1
Kaleb Smith,NO,20,2004-05-14,2004,6,188,RW,Erie Otters,68,10,14,24,0.35,-4,0,0,0,0,1,1,3,0,38,1
Ihnat Pazii,YES,13,2006-12-04,2006,5.08,155,LW,North Bay Battalion,63,9,15,24,0.38,5,1,1,2,0,0,0,3,0,29,1
Ivan Galiyanov,YES,92,2007-10-16,2007,5.09,154,LW,Niagara IceDogs,60,8,16,24,0.4,-30,0,1,1,1,1,2,0,0,13,1
Matthew Mayich,NO,22,2004-12-21,2004,6.02,197,D,Ottawa 67's,66,6,18,24,0.36,14,0,1,1,1,1,2,0,0,77,1
Paul Christopoulos,NO,4,2003-03-26,2003,5.1,203,D,North Bay Battalion,68,3,21,24,0.35,32,0,0,0,0,1,1,1,0,28,1
Kai Schwindt,NO,20,2003-12-17,2003,6.03,195,LW,Sarnia Sting,33,13,10,23,0.7,-1,6,2,8,0,0,0,0,0,30,1
Caden Taylor,YES,19,2007-03-31,2007,6.02,185,LW,Peterborough Petes,58,12,11,23,0.4,-24,4,4,8,0,0,0,0,0,34,1
Marc Boudreau,NO,89,2003-04-29,2003,6.02,190,LW,Mississauga Steelheads,64,12,11,23,0.36,12,0,0,0,0,0,0,1,0,86,1
Gavin Grundner,NO,16,2004-05-12,2004,6,179,LW,Guelph Storm,59,7,16,23,0.39,14,0,1,1,0,1,1,0,1,27,1
Matthew Mania,NO,93,2005-01-11,2005,6.01,190,D,Sudbury Wolves,45,4,19,23,0.51,4,2,5,7,0,0,0,0,0,28,1
Cameron Reid,YES,18,2007-04-08,2007,6,175,LD,Kitchener Rangers,49,2,21,23,0.47,18,0,2,2,0,0,0,0,0,17,1
Julian Fantino,NO,27,2004-02-05,2004,6.01,200,RW,Soo Greyhounds,58,12,10,22,0.38,10,0,0,0,0,0,0,2,0,37,1
Carter Kostuch,YES,18,2007-04-21,2007,5.11,157,LW,Sarnia Sting,65,11,11,22,0.34,-17,3,2,5,0,0,0,1,0,23,1
Chris Barlas,NO,9,2005-01-10,2005,5.1,185,LW,Ottawa 67's,54,10,12,22,0.41,12,2,1,3,0,0,0,0,1,46,1
Luca Romano,YES,86,2007-06-25,2007,5.11,168,C,Kitchener Rangers,56,10,12,22,0.39,1,2,2,4,0,0,0,0,1,8,1
Chase Coughlan,NO,9,2005-06-17,2005,5.11,192,RW,Sudbury Wolves,61,10,12,22,0.36,6,0,0,0,0,0,0,2,0,87,1
Braden Haché,NO,6,2003-05-21,2003,6.03,210,D,Saginaw Spirit,65,9,13,22,0.34,27,0,0,0,0,0,0,1,0,89,1
Caeden Carlisle,NO,7,2004-01-31,2004,6.02,197,D,Soo Greyhounds,66,4,18,22,0.33,19,0,1,1,0,1,1,1,0,74,1
Urban Podrekar,NO,86,2005-02-14,2005,5.11,181,D,Niagara IceDogs,62,3,19,22,0.35,-32,0,4,4,0,3,3,0,0,30,1
Jack Dever,NO,18,2005-09-05,2005,5.1,175,RW,Ottawa 67's,55,9,12,21,0.38,-1,1,2,3,1,1,2,2,2,2,1
Jack Brauti,YES,6,2006-05-24,2006,6,165,D,Barrie Colts,62,9,12,21,0.34,-8,1,2,3,1,0,1,0,0,60,1
Thomas Budnick,NO,22,2004-02-14,2004,6.01,210,D,Guelph Storm,63,3,18,21,0.33,3,0,3,3,0,0,0,0,0,82,1
Marko Stojkov,NO,95,2004-08-11,2004,6,170,D,Flint Firebirds,64,2,19,21,0.33,-40,1,6,7,0,0,0,1,0,26,1
Gavin Ewles,NO,7,2005-03-01,2005,6.01,191,D,Flint Firebirds,65,2,19,21,0.32,-10,0,3,3,0,1,1,0,0,32,1
Ryan Brown,YES,23,2007-10-27,2007,5.11,159,LW,Sarnia Sting,49,11,9,20,0.41,-8,0,4,4,0,0,0,0,1,4,1
Leo Serlin,YES,20,2006-01-20,2006,6,186,RW,Guelph Storm,64,10,10,20,0.31,-2,0,5,5,2,0,2,2,0,23,1
Jimmy Lombardi,YES,10,2007-02-16,2007,5.11,149,C,Flint Firebirds,62,7,13,20,0.32,-11,0,2,2,0,0,0,2,0,12,1
Cameron Mercer,NO,14,2005-05-27,2005,6,180,C,Kitchener Rangers,65,6,14,20,0.31,-6,0,1,1,0,0,0,0,0,38,1
William Nicholl,YES,73,2006-05-24,2006,6,170,C,London Knights,65,6,14,20,0.31,-2,0,0,0,0,1,1,0,0,38,1
Tomáš Hamara,NO,9,2004-03-09,2004,6,192,D,Brantford Bulldogs,44,1,19,20,0.45,30,0,5,5,0,0,0,1,0,22,1
Kimi Körbler,YES,24,2006-09-25,2006,5.1,157,RW,Ottawa 67's,60,10,9,19,0.32,7,0,2,2,1,0,1,2,0,14,1
Jakub Chromiak,NO,7,2005-11-02,2005,5.11,183,D,Kingston Frontenacs,55,5,14,19,0.35,-10,0,1,1,0,0,0,1,0,18,1
Justin Bottineau,NO,77,2006-01-11,2006,6,168,LW,Kitchener Rangers,61,5,14,19,0.31,2,0,2,2,0,0,0,1,0,28,1
Grayson Tiller,NO,8,2005-02-20,2005,5.1,190,D,Barrie Colts,61,3,16,19,0.31,-9,0,0,0,0,2,2,0,0,51,1
Owen Protz,YES,12,2006-02-07,2006,6.02,207,D,Brantford Bulldogs,66,3,16,19,0.29,4,0,1,1,0,2,2,1,0,49,1
Quinton Pagé,NO,14,2005-08-03,2005,5.07,169,LW,Peterborough Petes,61,15,3,18,0.3,-31,6,1,7,0,0,0,1,0,24,1
Gage Heyes,NO,9,2004-04-21,2004,5.11,158,RW,Kingston Frontenacs,65,11,7,18,0.28,-11,0,0,0,0,1,1,0,1,64,1
Mitchell Martin,NO,59,2003-01-06,2003,6.04,206,LW,Kitchener Rangers,21,10,8,18,0.86,10,1,1,2,1,0,1,0,0,43,1
Daylen Moses,NO,24,2005-06-13,2005,6.02,180,C,Sarnia Sting,50,9,9,18,0.36,-18,0,0,0,1,0,1,2,1,56,1
Jack Nesbitt,YES,71,2007-01-12,2007,6.04,183,C,Windsor Spitfires,58,9,9,18,0.31,-32,3,2,5,0,0,0,0,0,58,1
Djibril Toure,NO,67,2003-06-05,2003,6.07,203,D,Windsor Spitfires,45,8,10,18,0.4,15,0,0,0,0,1,1,0,0,69,1
Jacob Holmes,NO,47,2003-07-04,2003,6.02,211,D,Kingston Frontenacs,54,8,10,18,0.33,-8,5,4,9,0,0,0,0,0,28,1
Nic Sima,NO,92,2005-03-31,2005,6.03,200,RW,Saginaw Spirit,60,8,10,18,0.3,3,1,1,2,0,0,0,0,1,45,1
Tristan Delisle,YES,40,2007-05-15,2007,5.11,167,C,Oshawa Generals,63,7,11,18,0.29,5,1,0,1,0,0,0,2,0,46,1
Noah Nelson,NO,11,2005-03-28,2005,6.01,186,C,Brantford Bulldogs,62,5,13,18,0.29,-7,0,0,0,0,0,0,1,0,21,1
Alec Leonard,NO,27,2004-05-13,2004,5.11,174,D,London Knights,66,4,14,18,0.27,13,0,0,0,0,2,2,1,0,82,1
Matthew Jenken,NO,27,2005-10-12,2005,6.04,200,D,Flint Firebirds,68,2,16,18,0.26,-21,1,0,1,0,0,0,0,0,39,1
Konnor Smith,NO,6,2004-11-06,2004,6.05,206,D,Owen Sound Attack,62,9,8,17,0.27,-21,0,0,0,0,0,0,0,4,74,1
Tyler Graham,NO,28,2006-08-10,2006,5.11,182,LW,Oshawa Generals,61,7,10,17,0.28,-10,1,0,1,0,0,0,1,0,28,1
Ethan Czata,YES,12,2007-05-29,2007,6,160,C,Niagara IceDogs,62,7,10,17,0.27,-35,1,1,2,0,0,0,0,0,42,1
Sean Doherty,YES,55,2006-03-23,2006,6.01,182,RW,Sarnia Sting,61,6,11,17,0.28,-11,0,1,1,0,0,0,0,0,6,1
Tnias Mathurin,NO,5,2004-01-15,2004,6.03,195,D,North Bay Battalion,51,3,14,17,0.33,26,0,0,0,1,2,3,1,0,28,1
Matthew Schaefer,YES,48,2007-09-05,2007,6.01,162,D,Erie Otters,56,3,14,17,0.3,-2,1,2,3,0,1,1,0,0,16,1
Bronson Ride,NO,25,2005-01-14,2005,6.06,209,D,North Bay Battalion,62,2,15,17,0.27,20,0,0,0,0,1,1,0,0,56,1
Maleek McGowan,NO,11,2005-06-13,2005,5.11,164,D,Kingston Frontenacs,63,2,15,17,0.27,-1,0,2,2,1,0,1,0,0,47,1
Nathan Poole,NO,28,2004-07-28,2004,6.01,200,C,Kingston Frontenacs,58,8,8,16,0.28,-16,0,0,0,2,2,4,3,0,40,1
Adrian Rebelo,NO,74,2004-06-22,2004,6.02,186,LW,Brantford Bulldogs,50,6,10,16,0.32,9,0,0,0,0,0,0,1,1,27,1
Owen Outwater,NO,93,2005-01-04,2005,6.02,168,LW,Windsor Spitfires,36,4,12,16,0.44,-2,1,3,4,0,0,0,2,0,16,1
Thomas Sirman,NO,6,2004-03-05,2004,5.1,178,D,Ottawa 67's,40,3,13,16,0.4,9,1,3,4,0,0,0,1,0,40,1
Wyatt Kennedy,NO,2,2005-05-27,2005,6.04,198,D,North Bay Battalion,67,2,14,16,0.24,-2,0,2,2,0,0,0,1,0,38,1
Cal Uens,NO,44,2005-02-11,2005,5.09,159,D,Kingston Frontenacs,65,1,15,16,0.25,-5,0,2,2,0,1,1,0,0,76,1
Bradley Horner,NO,5,2005-06-16,2005,6,192,RW,Ottawa 67's,59,6,9,15,0.25,14,0,0,0,0,0,0,2,0,44,1
Caden Kelly,NO,28,2006-01-15,2006,5.11,193,RW,Ottawa 67's,55,4,11,15,0.27,-3,0,0,0,0,0,0,0,0,39,1
Matthew Virgilio,NO,25,2006-03-24,2006,5.11,186,D,Soo Greyhounds,66,4,11,15,0.23,8,0,0,0,0,0,0,0,1,35,1
Noah Van Vliet,NO,2,2004-02-18,2004,6.03,220,D,Sudbury Wolves,68,4,11,15,0.22,0,0,0,0,0,0,0,0,0,44,1
Cam Gauvreau,NO,3,2003-03-08,2003,6.02,190,D,Peterborough Petes,57,3,12,15,0.26,-34,2,4,6,0,0,0,0,0,58,1
Conor Walton,YES,28,2006-04-22,2006,6.04,208,D,Windsor Spitfires,64,1,14,15,0.23,-24,0,0,0,0,2,2,1,0,32,1
Jeremy Martin,YES,15,2007-02-06,2007,6,179,LW,Flint Firebirds,64,13,1,14,0.22,-23,1,0,1,1,0,1,1,0,31,1
Michael Derbidge,NO,91,2005-04-04,2005,6.01,199,LW,Barrie Colts,32,5,9,14,0.44,-1,0,0,0,0,0,0,0,0,19,1
PJ Forgione,NO,27,2004-11-12,2004,6.02,215,D,Saginaw Spirit,41,5,9,14,0.34,19,0,0,0,0,0,0,1,0,48,1
Ryan Vannetten,NO,13,2004-03-30,2004,5.11,165,D,Niagara IceDogs,56,4,10,14,0.25,-30,0,0,0,0,1,1,0,0,10,1
Jackson Stewart,NO,22,2004-06-18,2004,6,198,LW,Owen Sound Attack,65,4,10,14,0.22,-8,0,0,0,0,0,0,1,0,119,1
Aiden Young,YES,26,2007-04-18,2007,5.1,165,LW,Peterborough Petes,58,3,11,14,0.24,-21,1,3,4,0,0,0,1,0,13,1
Alex Cajkovic,NO,26,2005-07-19,2005,5.1,179,D,Sarnia Sting,46,1,13,14,0.3,7,0,4,4,0,0,0,0,0,17,1
Jake Crawford,YES,16,2007-05-05,2007,6.03,163,C,Owen Sound Attack,57,6,7,13,0.23,-17,0,0,0,0,0,0,0,0,11,1
Tyler Hopkins,YES,91,2007-01-23,2007,6.01,160,C,Kingston Frontenacs,59,6,7,13,0.22,-20,0,1,1,0,1,1,0,0,17,1
Michael Podolioukh,NO,28,2004-11-28,2004,6.01,198,C,Niagara IceDogs,24,5,8,13,0.54,-7,0,0,0,2,2,4,1,0,20,1
Chris Grisolia,NO,81,2005-04-30,2005,6,182,C,Barrie Colts,45,5,8,13,0.29,-5,0,1,1,0,1,1,0,1,18,1
Lincoln Moore,NO,18,2005-09-21,2005,6.01,205,RW,Saginaw Spirit,50,5,8,13,0.26,-9,0,0,0,0,0,0,0,0,9,1
Ryan McGuire,NO,12,2004-02-29,2004,5.11,186,C,Guelph Storm,59,5,8,13,0.22,-9,0,3,3,0,0,0,0,0,103,1
Nathan Omeri,YES,27,2006-06-15,2006,5.11,175,D,Sarnia Sting,59,5,8,13,0.22,-13,1,1,2,1,0,1,1,0,14,1
Justin DeZoete,NO,11,2004-01-02,2004,6,192,LW,Soo Greyhounds,55,4,9,13,0.24,3,0,0,0,0,1,1,1,0,15,1
Carter Lowe,NO,85,2006-03-01,2006,6.03,209,LW,Barrie Colts,62,4,9,13,0.21,-11,3,0,3,0,0,0,0,0,10,1
Nico Addy,YES,22,2007-08-17,2007,6.04,213,RW,Peterborough Petes,60,3,10,13,0.22,-27,0,3,3,0,0,0,0,0,38,1
Blake Smith,NO,5,2004-10-05,2004,6.05,215,D,Flint Firebirds,65,2,11,13,0.2,6,0,0,0,0,0,0,0,0,46,1
Evan Van Gorp,YES,14,2006-05-18,2006,5.1,155,LW,London Knights,44,6,6,12,0.27,-7,0,0,0,1,0,1,0,0,14,1
Ethan Martin,NO,72,2005-03-25,2005,6.06,226,LW,Windsor Spitfires,55,6,6,12,0.22,-21,1,1,2,0,0,0,1,0,61,1
Aidan Castle,NO,90,2004-01-08,2004,6.01,180,LW,Saginaw Spirit,42,5,7,12,0.29,-6,0,0,0,0,0,0,0,0,14,1
Josef Eichler,NO,5,2005-12-14,2005,6,192,D,Windsor Spitfires,64,5,7,12,0.19,-31,1,2,3,0,0,0,0,0,128,1
Wil McFadden,YES,21,2007-02-15,2007,5.08,160,C,Guelph Storm,60,4,8,12,0.2,-3,2,2,4,0,0,0,0,0,11,1
Madden Steen,NO,5,2004-05-18,2004,6.02,214,D,Owen Sound Attack,60,3,9,12,0.2,-17,0,0,0,0,0,0,0,0,29,1
Stevie Leskovar,NO,4,2004-09-09,2004,6.03,207,D,Mississauga Steelheads,61,2,10,12,0.2,11,0,0,0,0,0,0,0,0,113,1
Derek Smyth,NO,2,2004-04-17,2004,6.05,212,D,Ottawa 67's,61,2,10,12,0.2,-6,0,1,1,0,0,0,0,0,49,1
David Bedkowski,NO,7,2006-12-07,2006,6.04,205,D,Oshawa Generals,68,2,10,12,0.18,5,0,0,0,0,0,0,0,0,48,1
Artem Frolov,YES,26,2007-05-05,2007,6,185,D,Niagara IceDogs,67,1,11,12,0.18,-37,0,0,0,0,0,0,0,0,43,1
William Eggleton,YES,18,2006-02-19,2006,5.11,174,LW,Mississauga Steelheads,64,8,3,11,0.17,0,0,0,0,0,0,0,1,1,41,1
Masen Wray,NO,71,2006-05-15,2006,6.03,177,C,Niagara IceDogs,63,5,6,11,0.17,-27,0,0,0,0,1,1,2,0,35,1
Blair Scott,NO,7,2005-04-14,2005,6.01,185,D,Barrie Colts,48,4,7,11,0.23,-16,1,0,1,0,0,0,2,0,45,1
Matthew Wang,NO,28,2005-08-22,2005,6.02,200,LW,Flint Firebirds,61,4,7,11,0.18,-7,0,0,0,0,0,0,0,0,37,1
Callum Cheynowski,NO,7,2006-08-04,2006,6.01,191,D,Niagara IceDogs,52,2,9,11,0.21,-26,1,0,1,0,0,0,0,0,16,1
Spencer Evans,YES,16,2006-05-12,2006,5.11,178,D,Soo Greyhounds,41,1,10,11,0.27,10,0,0,0,0,0,0,0,0,40,1
Kaeden Johnston,NO,37,2005-02-03,2005,6.01,175,RW,London Knights,40,6,4,10,0.25,-6,1,0,1,1,0,1,2,0,8,1
Evan Klein,NO,57,2004-01-12,2004,6.02,206,LW,Niagara IceDogs,62,6,4,10,0.16,-18,0,0,0,0,0,0,0,1,53,1
Andrew Wycisk,NO,75,2005-07-01,2005,5.11,177,D,Niagara IceDogs,29,5,5,10,0.34,-9,2,1,3,0,0,0,1,0,10,1
Gabriel Chiarot,YES,20,2006-09-17,2006,5.11,184,RW,Mississauga Steelheads,48,5,5,10,0.21,-1,0,0,0,0,0,0,1,0,38,1
Roman Kukumberg,NO,21,2005-03-01,2005,6.01,185,C,Sarnia Sting,24,4,6,10,0.42,-6,0,1,1,0,0,0,0,0,11,1
Will Bishop,NO,4,2005-03-17,2005,6.06,200,D,Saginaw Spirit,66,4,6,10,0.15,5,0,0,0,0,0,0,1,0,30,1
Vann Williamson,YES,27,2006-07-19,2006,6.02,162,D,Kingston Frontenacs,38,3,7,10,0.26,5,0,0,0,0,0,0,0,0,17,1
Lirim Amidovski,YES,29,2006-12-22,2006,6,170,RW,North Bay Battalion,57,3,7,10,0.18,-11,0,0,0,0,0,0,0,0,20,1
Zackary Sandhu,NO,72,2005-12-20,2005,6.01,193,D,Oshawa Generals,59,3,7,10,0.17,6,0,0,0,0,0,0,1,0,62,1
James Barr,YES,16,2007-06-01,2007,6.01,170,D,Sarnia Sting,38,2,8,10,0.26,0,1,3,4,0,0,0,0,0,6,1
Nic Whitehead,YES,10,2007-02-11,2007,5.1,154,C,Ottawa 67's,53,2,8,10,0.19,-3,0,3,3,0,0,0,0,0,26,1
Braedyn Rogers,NO,2,2006-11-22,2006,6,169,D,Owen Sound Attack,65,2,8,10,0.15,-10,0,1,1,0,0,0,0,0,17,1
Martin Matejicek,NO,5,2005-08-05,2005,6.02,207,D,Peterborough Petes,68,2,8,10,0.15,-35,1,1,2,0,0,0,0,0,34,1
Hughston Hurt,YES,72,2007-07-10,2007,6.01,178,D,Sarnia Sting,67,0,10,10,0.15,-12,0,0,0,0,0,0,0,0,42,1
Andrew Vermeulen,NO,79,2006-02-07,2006,6.01,202,LW,Niagara IceDogs,47,5,4,9,0.19,-16,0,0,0,0,0,0,0,0,22,1
Carson Hall,YES,10,2006-04-29,2006,6.02,183,LW,Sarnia Sting,51,5,4,9,0.18,-21,0,1,1,0,0,0,0,0,31,1
Beau Akey,NO,86,2005-02-11,2005,6,186,D,Barrie Colts,14,4,5,9,0.64,4,1,2,3,0,0,0,0,1,12,1
Markas Samenas,NO,42,2004-02-02,2004,6.05,215,C,Flint Firebirds,60,4,5,9,0.15,-9,0,1,1,0,0,0,0,0,29,1
Cam Allen,NO,11,2005-01-07,2005,6,198,D,Guelph Storm,25,2,7,9,0.36,-7,1,2,3,0,0,0,0,0,23,1
Rylan Singh,YES,5,2007-10-04,2007,5.11,164,D,Guelph Storm,42,1,8,9,0.21,9,0,3,3,0,0,0,0,0,9,1
Harry Nansi,YES,21,2007-09-10,2007,6.02,174,RW,Owen Sound Attack,41,0,9,9,0.22,-10,0,0,0,0,0,0,0,0,6,1
Connor Federkow,NO,4,2003-07-26,2003,5.1,188,D,Niagara IceDogs,63,0,9,9,0.14,-48,0,0,0,0,0,0,0,0,120,1
Cedricson Okitundu,NO,68,2004-01-03,2004,5.11,198,D,Brantford Bulldogs,43,5,3,8,0.19,-1,0,0,0,0,0,0,0,0,50,1
Hunter McKenzie,NO,14,2006-12-07,2006,6,190,LW,Guelph Storm,49,5,3,8,0.16,-6,0,0,0,0,0,0,0,0,19,1
Alex Messier,NO,21,2005-03-23,2005,6.03,213,LW,Erie Otters,63,5,3,8,0.13,-8,0,0,0,1,0,1,1,0,59,1
William Stewart,NO,20,2005-02-23,2005,6.02,180,RW,Niagara IceDogs,48,4,4,8,0.17,-13,0,0,0,0,1,1,1,0,14,1
Adam Cavallin,NO,37,2005-03-04,2005,5.11,182,C,Kingston Frontenacs,39,3,5,8,0.21,2,0,0,0,0,0,0,0,0,17,1
Parker Snelgrove,YES,9,2007-01-20,2007,6,175,C,Guelph Storm,50,1,7,8,0.16,-5,0,0,0,0,0,0,0,0,14,1
Chandler Romeo,NO,17,2003-07-16,2003,6.06,205,D,Guelph Storm,68,1,7,8,0.12,12,0,0,0,0,1,1,0,0,65,1
Luke Dragusica,YES,23,2007-02-16,2007,6.01,165,D,Mississauga Steelheads,47,0,8,8,0.17,17,0,0,0,0,0,0,0,0,55,1
Noah Roberts,NO,7,2005-12-02,2005,6.01,190,D,Brantford Bulldogs,53,0,8,8,0.15,12,0,0,0,0,1,1,0,0,84,1
Carson Campbell,NO,8,2006-06-08,2006,6.01,180,RD,Kitchener Rangers,58,0,8,8,0.14,-5,0,0,0,0,0,0,0,0,25,1
Charlie Hilton,YES,21,2006-09-15,2006,6.05,196,LW,Ottawa 67's,32,4,3,7,0.22,-2,0,0,0,0,0,0,0,0,29,1
Jack Greenwell,NO,10,2005-01-05,2005,6,172,RW,Windsor Spitfires,41,4,3,7,0.17,-16,0,0,0,0,0,0,0,0,2,1
Brodie McConnell-Barker,YES,8,2006-01-31,2006,6,180,D,Soo Greyhounds,41,3,4,7,0.17,5,0,0,0,0,0,0,0,0,28,1
Olivier Savard,NO,34,2005-01-14,2005,6.02,196,RD,Kitchener Rangers,54,3,4,7,0.13,1,0,0,0,0,1,1,0,1,43,1
Kieran Witkowski,YES,26,2007-02-07,2007,5.1,165,LW,Mississauga Steelheads,58,3,4,7,0.12,-1,0,0,0,0,0,0,1,0,6,1
Ethan Toms,YES,61,2006-01-19,2006,5.11,173,C,Oshawa Generals,59,3,4,7,0.12,-3,0,1,1,0,0,0,0,0,34,1
Quinn Beauchesne,YES,13,2007-03-01,2007,6,172,D,Guelph Storm,33,2,5,7,0.21,0,0,1,1,0,0,0,2,0,28,1
Jaiden Newton,YES,84,2007-10-13,2007,5.11,167,C,Barrie Colts,45,1,6,7,0.16,-11,0,0,0,0,0,0,0,0,15,1
Brayden Hislop,NO,6,2003-09-26,2003,6.01,181,D,Guelph Storm,48,1,6,7,0.15,-15,0,4,4,0,0,0,1,0,40,1
James Guo,NO,73,2005-04-02,2005,6.01,190,D,Saginaw Spirit,50,1,6,7,0.14,0,0,1,1,0,0,0,0,0,20,1
Reed Gee,NO,8,2006-03-12,2006,6,178,D,Mississauga Steelheads,47,0,7,7,0.15,-2,0,0,0,0,0,0,0,0,50,1
Ty Henry,YES,2,2006-07-19,2006,6.04,198,D,Erie Otters,54,0,7,7,0.13,0,0,0,0,0,2,2,0,0,44,1
Grayden Strohack,YES,6,2006-06-09,2006,6.03,183,D,Peterborough Petes,55,0,7,7,0.13,-13,0,0,0,0,0,0,0,0,76,1
Connor Toms,NO,52,2004-03-13,2004,5.11,174,D,Windsor Spitfires,61,0,7,7,0.11,-46,0,0,0,0,0,0,0,0,27,1
Rowan Topp,YES,3,2006-04-02,2006,6.02,195,D,Guelph Storm,64,0,7,7,0.11,-2,0,0,0,0,0,0,0,0,29,1
Pasquale Zito,NO,73,2003-06-01,2003,5.11,184,C,Windsor Spitfires,5,3,3,6,1.2,-7,1,1,2,0,0,0,0,0,2,1
Ryan Pryce,NO,74,2004-02-06,2004,6.02,197,D,Sudbury Wolves,40,3,3,6,0.15,7,1,0,1,0,0,0,0,0,18,1
Tuomas Uronen,NO,13,2005-03-19,2005,6,194,RW,Ottawa 67's,11,2,4,6,0.55,4,0,1,1,0,0,0,0,0,0,1
Henry Brzustewicz,YES,2,2007-02-09,2007,6.01,194,D,London Knights,52,2,4,6,0.12,7,0,0,0,0,0,0,1,0,20,1
Brett Hammond,YES,91,2006-09-08,2006,6.02,188,RW,Erie Otters,58,2,4,6,0.1,-12,0,0,0,0,0,0,0,0,14,1
Lucas Signoretti,NO,16,2004-03-30,2004,5.06,168,LW,Sudbury Wolves,15,1,5,6,0.4,4,1,0,1,0,0,0,0,0,2,1
Josh Brady,YES,3,2006-01-11,2006,6,191,D,Ottawa 67's,34,1,5,6,0.18,1,0,0,0,0,0,0,0,0,14,1
Antonio Tersigni,NO,37,2006-05-03,2006,5.1,171,LW,Owen Sound Attack,52,1,5,6,0.12,-25,0,0,0,0,0,0,0,0,6,1
Owen Griffin,YES,96,2007-04-08,2007,5.1,157,C,Oshawa Generals,61,1,5,6,0.1,-16,0,0,0,0,0,0,1,0,13,1
Nathan Sauder,NO,5,2005-02-01,2005,6.01,199,D,Erie Otters,64,1,5,6,0.09,-6,0,0,0,0,1,1,0,0,42,1
Daniel Chen,YES,27,2006-08-04,2006,6.04,186,D,Brantford Bulldogs,47,0,6,6,0.13,-8,0,0,0,0,0,0,0,0,20,1
Tanner Winegard,NO,91,2005-01-11,2005,6.06,221,D,Windsor Spitfires,53,0,6,6,0.11,-18,0,0,0,0,0,0,0,0,27,1
Brennan Faulkner,NO,28,2005-12-28,2005,5.1,161,LW,Peterborough Petes,64,0,6,6,0.09,-34,0,1,1,0,0,0,0,0,16,1
Wesley Royston,YES,77,2007-11-22,2007,6.03,174,RW,Erie Otters,45,4,1,5,0.11,-4,0,0,0,0,0,0,0,0,34,1
Jared Woolley,YES,51,2006-02-27,2006,6.04,214,D,London Knights,37,3,2,5,0.14,5,0,1,1,0,0,0,0,0,21,1
Sawyer Boulton,NO,36,2004-07-12,2004,6,210,RW,London Knights,40,3,2,5,0.13,-14,0,1,1,0,0,0,1,0,63,1
Ryan Struthers,NO,26,2004-01-02,2004,6.01,182,LW,Windsor Spitfires,45,3,2,5,0.11,-19,0,0,0,0,0,0,0,0,17,1
Dennis Lominac,YES,93,2006-01-11,2006,5.1,168,LW,Sarnia Sting,58,3,2,5,0.09,-25,0,0,0,0,0,0,0,0,65,1
Ryder Boulton,YES,11,2006-06-21,2006,5.1,194,LW,London Knights,45,2,3,5,0.11,-11,0,0,0,0,0,0,0,0,56,1
MacGregor Richmond,YES,78,2006-08-06,2006,5.09,180,RW,Mississauga Steelheads,63,2,3,5,0.08,-14,0,1,1,0,0,0,1,0,25,1
Max Dirracolo,YES,25,2006-06-29,2006,6.04,216,LD,Kitchener Rangers,31,1,4,5,0.16,3,0,0,0,0,0,0,0,0,16,1
Dylan Tsherna,YES,18,2007-02-22,2007,5.11,171,RW,Brantford Bulldogs,37,1,4,5,0.14,-3,0,0,0,0,0,0,0,0,18,1
Trevor McDowell,NO,12,2004-07-31,2004,6.04,205,D,North Bay Battalion,45,1,4,5,0.11,5,0,0,0,0,0,0,0,0,15,1
Daks Klinkhammer,NO,73,2005-08-14,2005,6,197,LW,Flint Firebirds,55,1,4,5,0.09,-11,0,0,0,0,0,0,0,0,20,1
Lane Sim,YES,92,2007-05-09,2007,5.07,160,LW,Sarnia Sting,43,0,5,5,0.12,-16,0,0,0,0,0,0,0,0,4,1
Nikita Tarasevich,NO,12,2003-02-09,2003,5.1,184,RW,Oshawa Generals,14,2,2,4,0.29,-3,0,1,1,0,0,0,1,1,0,1
Ryan Humphrey,NO,22,2003-04-08,2003,6,175,RW,Niagara IceDogs,17,2,2,4,0.24,-7,0,1,1,0,0,0,0,0,22,1
Tate Vader,YES,9,2006-01-09,2006,5.11,183,C,Soo Greyhounds,23,2,2,4,0.17,4,0,0,0,0,0,0,1,0,0,1
Joshua Avery,NO,86,2007-01-30,2007,5.11,165,C,Brantford Bulldogs,7,1,3,4,0.57,2,0,0,0,0,0,0,0,0,0,1
Chase Yanni,YES,16,2007-01-08,2007,5.1,171,LW,Ottawa 67's,10,1,3,4,0.4,-2,0,0,0,0,0,0,0,0,6,1
Liam Storch,NO,21,2006-01-20,2006,5.09,145,RW,Saginaw Spirit,22,1,3,4,0.18,-4,0,0,0,0,0,0,0,0,4,1
Josh Glavin,NO,5,2006-09-24,2006,6.02,190,D,Saginaw Spirit,33,0,4,4,0.12,5,0,0,0,0,0,0,0,0,59,1
Brayden Turley,NO,7,2006-08-08,2006,6.01,193,D,North Bay Battalion,41,0,4,4,0.1,6,0,0,0,0,0,0,0,0,16,1
William Haley,NO,17,2005-10-15,2005,6,177,D,Peterborough Petes,42,0,4,4,0.1,-18,0,0,0,0,0,0,0,0,31,1
Evan Passmore,YES,88,2006-12-05,2006,6.03,198,D,Barrie Colts,53,0,4,4,0.08,-4,0,0,0,0,0,0,0,0,38,1
Rylan Fellinger,YES,65,2007-05-16,2007,6.03,183,D,Flint Firebirds,58,0,4,4,0.07,-11,0,0,0,0,0,0,0,0,10,1
Brody Partridge,YES,11,2006-09-14,2006,5.09,162,C,Peterborough Petes,60,3,0,3,0.05,-21,0,0,0,0,0,0,0,0,9,1
Dylan Richter,YES,10,2006-07-11,2006,5.08,184,C,North Bay Battalion,24,2,1,3,0.13,-6,0,0,0,0,0,0,0,0,6,1
Matheas Stark,YES,28,2007-01-14,2007,6,161,LW,Kitchener Rangers,41,2,1,3,0.07,3,0,0,0,0,0,0,2,0,0,1
Cameron Arquette,YES,11,2007-04-27,2007,5.08,170,RW,Kitchener Rangers,13,1,2,3,0.23,3,0,0,0,0,0,0,0,0,0,1
Tomislav Brennan,NO,19,2005-03-15,2005,6,171,C,Owen Sound Attack,34,1,2,3,0.09,-7,0,0,0,0,0,0,0,0,15,1
Blake Arrowsmith,YES,18,2007-04-17,2007,6,181,RW,London Knights,9,0,3,3,0.33,2,0,0,0,0,0,0,0,0,2,1
Owen MacDonald,NO,6,2004-08-28,2004,6.01,188,D,Sarnia Sting,29,0,3,3,0.1,-8,0,0,0,0,0,0,0,0,42,1
Nicholas Holomego,YES,65,2006-05-19,2006,6.05,202,D,Erie Otters,43,0,3,3,0.07,-4,0,0,0,0,0,0,0,0,19,1
Liam Ladds,YES,8,2007-10-28,2007,6.01,151,D,Peterborough Petes,50,0,3,3,0.06,-28,0,0,0,0,0,0,0,0,26,1
Nathan Gaymes,NO,73,2006-02-03,2006,6,172,RW,Windsor Spitfires,4,2,0,2,0.5,1,0,0,0,0,0,0,0,0,9,1
Rafek Dianov,YES,22,2007-02-25,2007,5.11,170,LW,Niagara IceDogs,16,2,0,2,0.13,-10,0,0,0,0,0,0,0,0,0,1
Braeden O'Keefe,NO,42,2005-06-08,2005,5.09,170,C,Brantford Bulldogs,3,1,1,2,0.67,1,0,0,0,0,0,0,0,0,0,1
Nolan Laird,YES,19,2006-01-04,2006,6.01,180,C,North Bay Battalion,25,1,1,2,0.08,-5,0,0,0,0,0,0,0,0,6,1
Joseph Cadorin,YES,16,2007-03-29,2007,5.11,144,LW,Peterborough Petes,52,1,1,2,0.04,-23,0,0,0,0,0,0,0,0,36,1
Liam Spencer,YES,44,2006-01-19,2006,6.04,215,D,Mississauga Steelheads,4,0,2,2,0.5,-1,0,0,0,0,0,0,0,0,2,1
Niko Krmpotic,YES,10,2007-04-19,2007,6.01,185,D,Brantford Bulldogs,9,0,2,2,0.22,-1,0,0,0,0,0,0,0,0,2,1
Noah Smith,YES,26,2006-02-27,2006,6.02,172,D,Barrie Colts,12,0,2,2,0.17,-9,0,0,0,0,0,0,0,0,4,1
Matthew Andersen,YES,21,2007-11-27,2007,6,174,D,Sarnia Sting,13,0,2,2,0.15,-7,0,0,0,0,1,1,0,0,4,1
Lucas Rodriguez,YES,26,2006-04-26,2006,6.02,183,D,Oshawa Generals,18,0,2,2,0.11,6,0,0,0,0,0,0,0,0,13,1
Jonathon Pylypuik,YES,18,2006-03-25,2006,6.01,163,LW,Oshawa Generals,48,0,2,2,0.04,-8,0,0,0,0,0,0,0,0,21,1
Quinn Binnie,NO,27,2004-04-29,2004,6,198,RW,Peterborough Petes,57,0,2,2,0.04,-25,0,0,0,0,0,0,0,0,18,1
Lucas Di Giantommaso,NO,92,2005-11-14,2005,5.11,165,RW,Sudbury Wolves,3,1,0,1,0.33,2,0,0,0,0,0,0,0,0,0,1
Reyth Smith,YES,20,2007-07-27,2007,6.01,169,C,North Bay Battalion,3,1,0,1,0.33,0,0,0,0,0,0,0,0,0,0,1
Jacob Cloutier,YES,42,2007-03-22,2007,5.09,165,RW,Saginaw Spirit,4,1,0,1,0.25,-1,0,0,0,0,0,0,1,0,2,1
Adrian Manzo,YES,2,2007-08-28,2007,6.01,170,D,Windsor Spitfires,5,1,0,1,0.2,3,0,0,0,0,0,0,0,0,2,1
Cameron Bergeron,YES,20,2006-04-16,2006,5.11,181,D,Kingston Frontenacs,7,1,0,1,0.14,-2,0,0,0,0,0,0,0,0,0,1
Xander Velliaris,YES,77,2007-04-23,2007,6.03,185,D,Kingston Frontenacs,10,1,0,1,0.1,2,0,0,0,0,0,0,0,0,0,1
Nolan Newton,YES,16,2006-01-27,2006,5.1,173,RW,Barrie Colts,13,1,0,1,0.08,-4,0,0,0,0,0,0,0,0,4,1
Georgy Toroptsev,YES,8,2006-04-22,2006,6,179,LW,Erie Otters,18,1,0,1,0.06,-3,0,0,0,0,0,0,0,0,11,1
Harrison Franssen,YES,12,2006-05-06,2006,6.03,183,C,Oshawa Generals,2,0,1,1,0.5,1,0,0,0,0,0,0,0,0,0,1
Ben Radley,YES,77,2007-07-29,2007,6,176,D,Brantford Bulldogs,4,0,1,1,0.25,5,0,0,0,0,0,0,0,0,0,1
Nolan Jackson,YES,5,2007-01-02,2007,6,168,D,Sudbury Wolves,6,0,1,1,0.17,-1,0,0,0,0,0,0,0,0,2,1
Darcy Dewachter,YES,24,2007-03-01,2007,5.11,170,D,Niagara IceDogs,11,0,1,1,0.09,-1,0,0,0,0,0,0,0,0,0,1
Eric He,YES,98,2007-10-15,2007,6.02,183,LW,Niagara IceDogs,12,0,1,1,0.08,0,0,0,0,0,0,0,0,0,0,1
Alec Stewart,NO,25,2005-04-02,2005,5.11,170,C,Windsor Spitfires,13,0,1,1,0.08,-4,0,0,0,0,0,0,0,0,2,1
Caeden Heins,YES,44,2006-02-06,2006,6.01,172,LW,Oshawa Generals,28,0,1,1,0.04,-3,0,0,0,0,0,0,0,0,6,1
Rene Van Bommel,YES,55,2006-05-14,2006,5.11,180,LW,London Knights,29,0,1,1,0.03,-7,0,0,0,0,0,0,0,0,17,1
Brayden Velliaris,NO,25,2005-04-16,2005,6.02,205,D,Peterborough Petes,32,0,1,1,0.03,-5,0,0,0,0,0,0,0,0,30,1
Duncan Schneider,NO,44,2005-07-05,2005,6.02,201,D,Sarnia Sting,33,0,1,1,0.03,-14,0,0,0,0,0,0,0,0,32,1
Devin Mauro,NO,23,2004-06-06,2004,5.08,165,LW,Sudbury Wolves,38,0,1,1,0.03,0,0,0,0,0,0,0,0,0,17,1
Dylan Woulds,YES,24,2006-03-28,2006,6,196,D,Peterborough Petes,45,0,1,1,0.02,1,0,0,0,0,0,0,0,0,12,1
Brett Bouchard,NO,23,2005-01-18,2005,6,167,C,North Bay Battalion,1,0,0,0,0,0,0,0,0,0,0,0,0,0,0,1
Blake Clayton,YES,24,2007-10-23,2007,6,165,C,Sudbury Wolves,1,0,0,0,0,1,0,0,0,0,0,0,0,0,0,1
Briir Long,YES,42,2007-07-22,2007,6,165,C,Brantford Bulldogs,1,0,0,0,0,0,0,0,0,0,0,0,0,0,0,1
Shawn Costello,YES,32,2007-01-20,2007,6.02,188,C,Oshawa Generals,2,0,0,0,0,-1,0,0,0,0,0,0,0,0,2,1
Brendan Gerber,YES,77,2007-02-24,2007,5.09,179,LW,London Knights,2,0,0,0,0,0,0,0,0,0,0,0,0,0,0,1
Adriano Tonin,NO,27,2005-11-02,2005,6,191,LW,Windsor Spitfires,2,0,0,0,0,-1,0,0,0,0,0,0,0,0,0,1
Roman Buduev,YES,47,2006-01-12,2006,5.11,170,D,Niagara IceDogs,3,0,0,0,0,-2,0,0,0,0,0,0,0,0,0,1
PJ Fagan II,YES,67,2007-05-02,2007,6,205,D,London Knights,3,0,0,0,0,1,0,0,0,0,0,0,0,0,4,1
Alexey Kulikov,NO,29,2004-08-19,2004,6.01,175,LW,Niagara IceDogs,3,0,0,0,0,-2,0,0,0,0,0,0,0,0,2,1
Michael Lavigne,YES,3,2007-01-17,2007,6.05,200,D,Windsor Spitfires,3,0,0,0,0,-1,0,0,0,0,0,0,0,0,0,1
Nathan Leek,NO,21,2005-09-16,2005,6.01,195,LW,Peterborough Petes,3,0,0,0,0,-1,0,0,0,0,0,0,0,0,0,1
Carson Lloyd,NO,21,2005-12-08,2005,6,188,D,Brantford Bulldogs,3,0,0,0,0,2,0,0,0,0,0,0,0,0,2,1
Kyler Morgan,NO,36,2005-05-07,2005,6.01,185,LW,Windsor Spitfires,3,0,0,0,0,-2,0,0,0,0,0,0,0,0,0,1
Trevor O’Dell,YES,4,2006-07-17,2006,6.03,166,D,Sudbury Wolves,3,0,0,0,0,-1,0,0,0,0,0,0,0,0,0,1
Ethan Quick,NO,10,2005-01-27,2005,6.01,196,RW,Peterborough Petes,3,0,0,0,0,-2,0,0,0,0,0,0,0,0,0,1
Jack D'Arcy,YES,25,2007-12-02,2007,5.09,144,D,Flint Firebirds,4,0,0,0,0,0,0,0,0,0,0,0,0,0,2,1
Spencer Horgan,NO,2,2005-03-17,2005,6,173,D,Sudbury Wolves,4,0,0,0,0,0,0,0,0,0,0,0,0,0,0,1
Wyatt Jinman,YES,21,2007-10-11,2007,6.02,160,LW,Mississauga Steelheads,4,0,0,0,0,-1,0,0,0,0,0,0,0,0,0,1
Hudson Chitaroni,YES,41,2007-08-22,2007,5.1,174,C,Sudbury Wolves,5,0,0,0,0,-3,0,0,0,0,0,0,0,0,4,1
Cole Dubowsky,YES,27,2007-06-11,2007,6.01,175,LW,Barrie Colts,5,0,0,0,0,-3,0,0,0,0,0,0,0,0,0,1
Andrew MacNiel,YES,43,2007-07-25,2007,6.02,170,D,Kitchener Rangers,5,0,0,0,0,0,0,0,0,0,0,0,0,0,0,1
Ethan Weir,YES,73,2007-01-10,2007,6,185,RW,Kingston Frontenacs,5,0,0,0,0,-3,0,0,0,0,0,0,0,0,0,1
Braydon Bruce,YES,20,2006-05-11,2006,6.05,191,D,Sudbury Wolves,6,0,0,0,0,1,0,0,0,0,0,0,0,0,4,1
Ethan MacKinnon,NO,17,2003-05-22,2003,6.01,179,D,London Knights,6,0,0,0,0,0,0,0,0,0,0,0,0,0,4,1
Zach Wilson,YES,22,2007-03-07,2007,6.06,180,D,North Bay Battalion,6,0,0,0,0,-2,0,0,0,0,0,0,0,0,2,1
Kaleb Dietsch,NO,4,2007-01-03,2007,6.02,176,D,Ottawa 67's,7,0,0,0,0,1,0,0,0,0,0,0,0,0,0,1
Evan Hjelholt,YES,7,2006-12-14,2006,6.02,200,D,Windsor Spitfires,7,0,0,0,0,-3,0,0,0,0,0,0,0,0,0,1
Noah Jenken,YES,24,2007-03-08,2007,6.03,160,D,London Knights,7,0,0,0,0,1,0,0,0,0,0,0,0,0,2,1
Grant Spada,YES,8,2007-06-24,2007,6.05,186,D,Guelph Storm,7,0,0,0,0,-1,0,0,0,0,0,0,0,0,0,1
Tyler O'Toole,YES,28,2006-06-28,2006,6.02,194,D,Sarnia Sting,8,0,0,0,0,-4,0,0,0,0,0,0,0,0,14,1
Casey Bridgewater,YES,17,2007-02-07,2007,5.1,168,D,Sarnia Sting,9,0,0,0,0,-2,0,0,0,0,0,0,0,0,2,1
Sam Ethier,YES,36,2006-08-09,2006,6,187,D,Owen Sound Attack,11,0,0,0,0,-5,0,0,0,0,0,0,0,0,0,1
Gabriel Smith,YES,38,2007-01-01,2007,6.03,197,D,Owen Sound Attack,11,0,0,0,0,-3,0,0,0,0,0,0,0,0,2,1
Justin Handsor,YES,24,2007-09-24,2007,6.01,185,D,Barrie Colts,13,0,0,0,0,-4,0,0,0,0,0,0,0,0,2,1
Stef Forgione,NO,28,2005-04-29,2005,5.1,175,RW,North Bay Battalion,14,0,0,0,0,-4,0,0,0,0,0,0,0,0,13,1
Tyson Rismond,YES,17,2006-03-30,2006,6.02,185,D,North Bay Battalion,14,0,0,0,0,-1,0,0,0,0,0,0,0,0,13,1
Fraser McDonell,YES,6,2006-03-02,2006,6.07,220,D,Oshawa Generals,26,0,0,0,0,-10,0,0,0,0,0,0,0,0,14,1
